NO ./textures/blue_stone.xpm
SO ./textures/color_stone.xpm
WE ./textures/grey_stone.xpm
EA ./textures/purple_stone.xpm


F 220,100,0
C 225,30,0


                                 
        1111111111111111111111111
        1000000000110000000000001
        1011000001110000000000001  
        1001000001000000000000001
111111111011000001110000000000001
100000000011000001110111111111111
1111111111 111111100000010001   1
11110111111111011101010010001   1
11000000110101011100000010001
10000000000000000000000010001
10000000000000001101010000001
11000001110101011111011110N01
11110111 1110101 101111010001
11111111 1111111 111111111111