NO ./textures/blue_stone.xpm
SO ./textures/color_stone.xpm
WE ./textures/grey_stone.xpm
EA ./textures/purple_stone.xpm


F 220,100,0
C 225,30,0


11111111111111111111111111111
11111111100000000011000000001
11111111101100000111000000001
11111111100100000000000000001
11111111101100000111000000001
10000000001100000111011111111
11110111111111011100000010001
11110111111111011101010000001
110000001101010111000000100N1
11111111111111111111111111111