NO ./path_to_the_north_texture
SO ./path_to_the_south_texture
WE ./path_to_the_west_texture
EA ./path_to_the_east_texture


F 220,100,0
C 225,30,0


111111111111111
111111000111111
111110000011111
1111000N0001111
111000000000111
110000000000011
100001111100001
110000111000011
111000010000111
111100000001111
1111100S0011111
111111000111111
111111111111111