NO ./textures/blue_stone.xpm
SO ./textures/color_stone.xpm
WE ./textures/grey_stone.xpm
EA ./textures/purple_stone.xpm


F 220,100,100
C 225,30,100


111111111111111
111111100111111
111110111011111
1111001111001111
1110001110000111
1100000000000011
1100     111N111
1101      100011
1110111111110111
111000000001111
110000000001111
111111111111111
111111111111111