NO ./textures/blue_stone.xpm
SO ./textures/color_stone.xpm
WE ./textures/grey_stone.xpm
EA ./textures/purple_stone.xpm


F 220,100,100
C 225,30,100


011111111111111
111111100011111
111111000100001
11111000N010111
111100001000011
110000000000011
100001111100011
110000111000011
111000010000111
111100000000001
111110000000001
111111111111111