NO ./textures/blue_stone.xpm
SO ./textures/color_stone.xpm
WE ./textures/grey_stone.xpm
EA ./textures/purple_stone.xpm


F 220,100,100
C 225,30,100

11111111111111111111
11111110001111111111
11111100010000111111
11111000N01011111111
111100001000011
110000000000011
100001111100011
110000111000011
111000010000111
111100000000001
111110000000001
111111111111111