1111111111111111111111111111111
10P000000100000K000000000100001
100000000100000000000000000E001
1000000000000000C00000000111111
10000000010000K0000000000000001
1000000001000000000000000000001
1000000C0000000C000000000000001
1000000001000000000000000100001
1000000001000000000000000000001
1000000000000000C00000000111111
1000000001000000000000000000001
1000K00001111111111111111111111
1000000C0000000C0000000000000C1
1000000C0000000C0000000000000C1
1000000C0000000C0000000000000C1
1000000C0000000C0000000000000C1
1C10000C0000000C0000000000000C1
1111111111111111111111111111111