111111
1P01E1
110011
1C0001
111111