111111
1P00E1
110001
1C10C1
111111